1111111
1P0C1E1
1011001
100C011
1111111
