11111111
1P0010E1
10001101
100C0001
11111111
