11111111
1P001E01
11000101
1C00C001
11111111
