11111111
1P0010E1
11000101
1C00C001
11111111
